##S#####################################
##.##.#.#..#.#.#..##..##....##.#.##....#
#..##...##.#...##.#..######.........####
##..###.#....###..##.##.#####.#.#####.##
###.##..##.#...##.......#..####.##.#...#
#....##....#.#..###.###...##.#.......###
##.#....##.####.#####.###..#.#.#####...#
#########..##......##.#.##.#.......##.##
#.##......####.#.#.........####.#####..#
#....####...##############.##.#.....####
##.#.#....###...................########
##.######...######.#.######.#.#....#...#
#..##.....###...#######.....###.####.###
##.#..#####.###.#.#.#.###.#.##.........#
#####.##.....#............###..##.#.####
#.#.########...#.#.#.#.#.###..##..#..#.#
#............#.#.#.###.#.##..##..###...#
##.######.##.#.#.#..##.#..##.###...##.##
#..#......#..#.#.#.##..##.#...##.#.##..#
######################################E#
